against.mid	Against All Odds	Phil Collins	Adult Contemporary
anyplace.mid	Anytime, Anyplace	Janet Jackson	Adult Contemporary
anytime.mid	Anytime you Need a Friend	Mariah Carey	Adult Contemporary
carly_simon_nobody_does_it_better.mid	Nobody Does it Better	Carly Simon	Adult Contemporary
celine_dion_all_by_myself.mid	All by Myself	Celine Dion	Adult Contemporary
comeback.mid	Come Back to Me	Janet Jackson	Adult Contemporary
go_the_distance.mid	Go the Distance	Michael Bolton	Adult Contemporary
haveitoldyoulately.mid	Have I Told You Lately	Rod Stewart	Adult Contemporary
HELLO.MID	Hello	Lionel Ritchie	Adult Contemporary
holding.mid	Holding back the Tears	Simply Red	Adult Contemporary
how_am_i_supposwithout_you.mid	How am I Supposed to Live Without You	Michael Bolton	Adult Contemporary
i'll_never_break_your_heart.mid	I'll Never Break Your Heart	Backstreet Boys	Adult Contemporary
in2deep.mid	In Too Deep	Phil Collins	Adult Contemporary
it's_all_comingk_to_me_now.mid	It's All Coming to Me Now	Celine Dion	Adult Contemporary
looking.mid	Looking In	Mariah Carey	Adult Contemporary
Private_Emotion.mid	Private Emotion	Enrique Iglesias	Adult Contemporary
suddenly.mid	Suddenly	Billy Ocean	Adult Contemporary
think_twice.mid	Think Twice	Celine Dion	Adult Contemporary
three_times_a_lady.mid	Three Times a Lady	Lionel Ritchie	Adult Contemporary
truecols.mid	True Colors	Cyndi Lauper	Adult Contemporary
unbreak.mid	Unbreak my Heart	Toni Braxton	Adult Contemporary
vision.mid	Vision of Love	Mariah Carey	Adult Contemporary
whitney_didntwealmosthaveitall.mid	Didn't We Almost Have it All	Whitney Houston	Adult Contemporary
Whitney_houston_i_will_always_love_you.mid	I Will Always Love You	Whitney Houston	Adult Contemporary
yursong.mid	Your Song	Elton John	Adult Contemporary
Aenima.mid	Aenima	Tool	Alternative Rock
alive.mid	Alive	Pearl Jam	Alternative Rock
ASK4IT2.MID	Ask For It	Hole	Alternative Rock
BLKHOLE.MID	Black Hole Sun	Soundgarden	Alternative Rock
bluemon.mid	Blue Monday	Orgy	Alternative Rock
Bound_For_The_Floor.mid	Bound for the Floor	Local H	Alternative Rock
december.mid	December	Collective Soul	Alternative Rock
Flagpole_Sitta.mid	Flagpole Sitta	Harvey Danger	Alternative Rock
gel.mid	Gel	Collective Soul	Alternative Rock
Heart_Shaped_Box.mid	Heart Shaped Box	Nirvana	Alternative Rock
heaven.mid	Heaven Beside You	Alice in Chains	Alternative Rock
Higher.mid	Higher	Creed	Alternative Rock
jesus_freak.mid	Jesus Freak	DC Talk	Alternative Rock
lithium.mid	Lithium	Nirvana	Alternative Rock
MY_WAVE.MID	My Wave	Soundgarden	Alternative Rock
myfavgame.mid	My Favorite Game	Cardigans	Alternative Rock
plush.mid	Plush	Stone Temple Pilots	Alternative Rock
PRECIOUS.MID	Precious Declaration	Collective Soul	Alternative Rock
ROOSTER.MID	Rooster	Alice In Chains	Alternative Rock
Smells_Like_Teen_Spirit.mid	Smells Like Teen Spirit	Nirvana	Alternative Rock
SMONICA.MID	Santa Monica	Everclear	Alternative Rock
The_Distance.mid	Distance	Cake	Alternative Rock
where_the_river_flows.mid	Where the River Flows	Collective Soul	Alternative Rock
WHEREBOY.MID	Where Boys Fear to Tread	The Smashing Pumpkins	Alternative Rock
WOULD.MID	Would	Alice In Chains	Alternative Rock
ac_chantons.mid	Chantons, chantons, et nous rejouissons	Andre Campra	Baroque
av_molti2.mid	Concerto Do maggiore RV558 con molti stromenti	Vivaldi	Baroque
av002a1.mid	Four Seasons La Primavera Allegro	Vivaldi	Baroque
av003.mid	Concerto No.6 in A	Vivaldi	Baroque
b0028_6.mid	Zeuch ein zu deinen Toren	Bach	Baroque
b0424.mid	Was bist du doch, o Seele, so betru	Bach	Baroque
bach531.mid	Prelude And Fugue For Organ In C	J. S. Bach	Baroque
bach7.mid	Sinfonia No. 8	J. S. Bach 	Baroque
bux_cfug.mid	Fugue In C	Buxtehude	Baroque
cibux183.mid	Durch Adams Fall	 Buxtehude 	Baroque
cm_altri_canti_damor.mid	Altri canti d'Amor	Claudio Monteverdi	Baroque
cm_combattimento1.mid	Ne Vol Tancredi et Notte, Che Nel Profondo	Monteverdi	Baroque
cm_ecco_pur.mid	Ecco pur, ch'a voi ritorno	Claudio Monteverdi	Baroque
cm_tu_se_morta.mid	L'Orfeo, Tu se morta	Monteverdi	Baroque
gfh_se_bramate_damar.mid	Se bramate d'amar	Handel	Baroque
gfh_va_tacito.mid	Va tacito e nascosto	Handel	Baroque
hand3.mid	Concerti Grossi Op.6 No.4 in A- Allegro	Handel	Baroque
hand6.mid	Gavotte For Flute With Harpsichord And Cello	Handel	Baroque
hp_amin.mid	Minuet in A minor	Henry Purcell	Baroque
hp_when_i_am.mid	When I am laid in earth	Henry Purcell	Baroque
k030.mid	Cat Fugue	Scarlatti	Baroque
k058.mid	Fugue, Esercizzio or Sonata, K 058	Scarlatti	Baroque
nun_komm_der_heiden_heiland.mid	Nun komm der Heiden Heiland	Pachelbel	Baroque
papillon.mid	Les Papillons	Couperin	Baroque
pfc_auree_trecce.mid	Auree trecce inanellate	Pier Francesco Cavalli 	Baroque
4on6.mid	4 on 6	Wes Montgomery	Bebop
4thAvenueTheme.mid	4th Avenue Theme	Anonymous	Bebop
52ndst.mid	52nd Street	Charlie Parker	Bebop
airegin.mid	Airegin	Sonny Rollins	Bebop
auprvave.mid	Au Privave	Charlie Parker	Bebop
billiesb.mid	Billie's Bounce	Charlie Parker	Bebop
Bluenboo.mid	Blue 'N Boogie	Dizzy Gillespie	Bebop
cooker_benson.mid	Cooker	George Benson	Bebop
dexterity.mid	Donna Lee	Charlie Parker	Bebop
donnalee.mid	Donna Lee	Charlie Parker	Bebop
evidence.mid	Evidence	Thelonious Monk	Bebop
grooving.mid	Grooving High	Dizzy Gillespie	Bebop
halfn.mid	Half Nelson	Charlie Parker	Bebop
havejones.mid	Have You Met Miss Jones?	Oscar Peterson	Bebop
inwalked.mid	In Walked Bud	Thelonious Monk	Bebop
lazybird.mid	Lazy Bird	John Coletrane	Bebop
mrpc.mid	Mr. P. C.	John Coletrane	Bebop
offminor.mid	Bebop	Thelonious Monk	Bebop
ornith.mid	Ornithology	Charlie Parker	Bebop
richjazz.mid	Rich Jazz	Anonymous	Bebop
scrapple.mid	Scrapple From the Apple	Charlie Parker	Bebop
softly.mid	Softly as in a Morning Sunrise	Modern Jazz Quartet	Bebop
straightn.mid	Straight No Chaser	Thelonious Monk	Bebop
wellyou.mid	Well, You Needn't	Thelonious Monk	Bebop
whisper.mid	Whisper	Benny Golson	Bebop
allthegoodtimes.mid	All the Good Times	Anonymous	Bluegrass
angeline.mid	Angeline	Anonymous	Bluegrass
arkansas.mid	Arkansas Traveller	Anonymous	Bluegrass
ballad.mid	Ballad of Jesse James	Anonymous	Bluegrass
banjointhehollow.mid	Banjo in the Hollow	Anonymous	Bluegrass
banjosignal.mid	Banjo Signal	Anonymous	Bluegrass
banksoftheohio.mid	Banks of the Ohio	Anonymous	Bluegrass
blackberry1.mid	Blackberry Blossom	Anonymous	Bluegrass
BlueGrass.mid	Blue Grass	Anonymous	Bluegrass
bluegrassboogie.mid	Bluegrass Boogie	Anonymous	Bluegrass
cherokee.mid	Cherokee	Anonymous	Bluegrass
countryroads.mid	Country Roads	Anonymous	Bluegrass
downyonder.mid	Down Yonder	Anonymous	Bluegrass
eightmoremilestolouisville.mid	Eight More Miles to Louiseville	Anonymous	Bluegrass
elevenmilecanyon.mid	Eleven Mile Canyon	Anonymous	Bluegrass
fireball.mid	Fireball Mountain	Anonymous	Bluegrass
foggymtnbrkdown.mid	Foggy Mountain Breakdown	Anonymous	Bluegrass
forked.mid	Forked Tail Deer	Anonymous	Bluegrass
goldrush.mid	Gold Rush	Anonymous	Bluegrass
johnhardy.mid	John Hardy	Anonymous	Bluegrass
liberty.mid	Liberty	Anonymous	Bluegrass
misty1.mid	Misty	Anonymous	Bluegrass
mountain.mid	Mountain Dew	Anonymous	Bluegrass
twodollarbill.mid	Two Dollar Bill	Anonymous	Bluegrass
unionman.mid	Union Man	Anonymous	Bluegrass
AlbertKing-BornUnderBadSign.mid	Born Under a Bad Sign	Albert King	Blues Rock
aleigha.mid	Aleigha	Anonymous	Blues Rock
AllmanBrothers-OneWayOut.mid	One Way Out	Allman Brothers Band	Blues Rock
AllmanBrothers-StatesBoroughBlues.mid	Statesborough Blues	Allman Brothers Band	Blues Rock
b00178.mid	Honey Bee	Stevie Ray Vaughn	Blues Rock
b00188.mid	I Can't Quit You Babe	Led Zeppelin	Blues Rock
b00192.mid	Pride and Joy	Stevie Ray Vaughn	Blues Rock
b00219.mid	Love Struck	Stevie Ray Vaughn	Blues Rock
b00245.mid	It's Not My Cross to Bear	Allman Brothers Band	Blues Rock
b00263.mid	I Pity the Fool	Paul Butterfield Blues Band	Blues Rock
b00300.mid	Stormy Monday	Allman Brothers Band	Blues Rock
b00317.mid	Texas Flood	Stevie Ray Vaughn	Blues Rock
BigBillBroonzy-KeyToTheHighway.mid	Key to The Highway	Derek and the Dominoes	Blues Rock
BuddyGuy-MaryHadALitltleLamb.mid	Mary had a Little Lamb	Buddy Guy	Blues Rock
Cold_Shot.mid	Cold Shot	Stevie Ray Vaughn	Blues Rock
Crossfire.mid	Crossfire	Stevie Ray Vaughn	Blues Rock
Crossroads_Blues.mid	Crossroads	Cream	Blues Rock
DATDoor.mid	Don't Answer the Door	BB King	Blues Rock
GoodMorningLittleSchoolGirl.mid	Good Morning Little Schoolgirl	Johnny Winter	Blues Rock
Hideaway.mid	Hideaway	John Mayall's Bluesbreakers	Blues Rock
LedZeppelin-SinceIveBeenLovingYouBaby.mid	Since I've Been Loving you Baby	Led Zeppelin	Blues Rock
roadhouse_blues.mid	Roadhouse Blues	Doors	Blues Rock
wmyself2.mid	Walking By Myself	Johnny Winter	Blues Rock
zz_top-la_grange.mid	La Grange	ZZ Top	Blues Rock
zz_top-tush.mid	Tush	ZZ Top	Blues Rock
AJobin-GirlIpanema.mid	Girl from Ipanema	Stan Getz	Bossa Nova
CARNAVAL.mid	Manana de Carnaval	Luis Bonfa	Bossa Nova
chega.mid	Chega de Saudade	Antonio Carlos Jobim	Bossa Nova
coisalin.mid	Coisalin	Tom Jobim	Bossa Nova
comerain.mid	Come Rain or Come Shine	Anonymous	Bossa Nova
Corcovad.mid	Corcovado	Stan Getz	Bossa Nova
day_fool.mid	Day Fool	Anonymous	Bossa Nova
Desafinado78.mid	Desafinado	A. C. Jobim	Bossa Nova
falando.mid	Falando	Tom Jobim	Bossa Nova
felicid.mid	A Felicidade	Antonio Carlos Jobim	Bossa Nova
GentleRain.mid	Gentle Rain	Luiz Bonfa	Bossa Nova
HowIns.mid	How Insensitive	Antonio Carlos Jobim	Bossa Nova
INSENSAT.MID	Insensatex	Anonymous	Bossa Nova
itapoan.mid	Itapoan	Tom Jobim	Bossa Nova
Jazzy_Bossa_Nova_Baby.mid	Jazzy Bossa Nova Baby	Anonymous	Bossa Nova
joy_bossa_nova.mid	Joy of Bossa Nova	Anonymous	Bossa Nova
Mamoita.mid	Mamoita	Anonymous	Bossa Nova
mvoyage.mid	Maiden Voyage	Herbie Hancock	Bossa Nova
nevrknow.mid	You'll Never Know	Anonymous	Bossa Nova
onenote.mid	One Note Samba	Antonio Carlos Jobim	Bossa Nova
orpheus.mid	Black Orpheus	Luis Bonfa	Bossa Nova
Sodanco.mid	So Danco Samba	Antonio Carlos Jobim	Bossa Nova
Triste.mid	Triste	Anonymous	Bossa Nova
Wave3.mid	Wave	Antonio Carlos Jobim	Bossa Nova
wavem.mid	Wavem	Tom Jobim	Bossa Nova
ahsurely.mid	Ah! Surely and the Steeplechase	Anonymous	Celtic
ashplant.mid	The Ash Plant	Anonymous	Celtic
athenry.mid	Lady Athenry	Turlough O'Carolan	Celtic
bashtunn.mid	A Bash in the Tunnel and Octupus' Pipes	Anonymous	Celtic
br_borus.mid	Brian Boru's March	Anonymous	Celtic
cisco.mid	The Maid of Mount Cisco	Anonymous	Celtic
iveagh.mid	Lady Iveagh	Thomas Connellan	Celtic
jollytin.mid	The Jolly Tinker	Anonymous	Celtic
kinglaoi.mid	March of the King of Laoise	O'Moore	Celtic
lamentoldsword.mid	Lament for the Old Sword	Anonymous	Celtic
maidneve.mid	The Maid I Never Forgot	Anonymous	Celtic
masons.mid	The Mason's Apron	Anonymous	Celtic
mullinvt.mid	The Reel of Mullinavat	Anonymous	Celtic
power.mid	Tommy Pott's Rambling Pitchfork	Anonymous	Celtic
rainyday.mid	The Rainy Day	Anonymous	Celtic
sbrave.mid	Scotland the Brave	Anonymous	Celtic
scarfuin.mid	The Partinf of the Friends	Anonymous	Celtic
scotsroyal.mid	Scots Royal	Anonymous	Celtic
scotswhahae.mid	Scos Wae Hae	Anonymous	Celtic
seanreid.mid	Sean Reids	Anonymous	Celtic
sgwelltor.mid	Scots Welcome to Toronto	Anonymous	Celtic
swagjig.mid	The Swaggering Jig	Anonymous	Celtic
swallowstail.mid	The Swallow's Tail	Anonymous	Celtic
tossfeth.mid	Toss the Feathers	Anonymous	Celtic
yellocks.mid	My Love with the Yellow Locks	Anonymous	Celtic
b00038.mid	Built For Comfort	Howlin' Wolf	Chicago Blues
b00181.mid	Honky Tonk	Clarence Gatemouth Brown	Chicago Blues
b00238.mid	My Babe	Little Walter	Chicago Blues
beforeac.mid	Before You Accuse Me	Bo Diddley	Chicago Blues
beforeyoucomeforme.mid	Before You Come for Me	Anonymous	Chicago Blues
BIG_BOSS.mid	Big Boss Man	Chicago Blues	Chicago Blues
blues_brothers-sweet_home.mid	Sweet Home Chicage	Blues Brothers	Chicago Blues
BLUES.mid	Blues	Anonymous	Chicago Blues
Boom_Boom_Boom.mid	Boom Boom Boom	John Lee Hooker	Chicago Blues
cc_rider.mid	C C Rider	Unknown	Chicago Blues
downalley.mid	Down in the Alley	Big Bill Broonzy	Chicago Blues
Dust_My_Broom.mid	Dust my Broom	Elmore James	Chicago Blues
Hey_Bartender.mid	Hey Bartender	Koko Taylor	Chicago Blues
hootieblues.mid	Hootie Blues	Unknown	Chicago Blues
JimmieYancey-StateStreetSpecial.mid	State Street Special	Jimmie Yancey	Chicago Blues
JohnLeeHooker-Dimples.mid	Dimples	John Lee Hooker	Chicago Blues
Juke.mid	Juke	Little Walter	Chicago Blues
Keep_It_To_Yourself.mid	Keep it to Yourself	Sonny Boy Williamson	Chicago Blues
Little_Red_Rooster.mid	Little Red Rooster	Howlin Wolf	Chicago Blues
MOJO.mid	Got My Mojo Working	Muddy Waters	Chicago Blues
MuddyWaters-HoochieCoochieMan.mid	Hoochie Coochie Man	Muddy Waters	Chicago Blues
OneBourbonOneScotchOneBeer.mid	One Bourbon One Scotch One Beer	John Lee Hooker	Chicago Blues
paul_butterfield-good_morning.mid	Good Mornin' Little School Girl	Paul Butterfield Blues Band	Chicago Blues
SonnyBoyWilliamsonII-DontStartMeToTalking.mid	Don't Start me Talkin'	Sonny Boy Williamson	Chicago Blues
SonnyBWilliamson-YourFuberalMyTrial.mid	Your Funeral my Trial	Sonny Boy Williamson	Chicago Blues
bastien04_befraget.mid	Befraget mich ein zartes Kind	Mozart	Classical
bjc17_2b.mid	Sonata for Keyboard Op17 No 2	CPE Bach	Classical
concerto_1_(c)izumi.mid	Concerto for two keyboards no1	Soler	Classical
concerto_flute_314-2.mid	Concerto for Flute and Orchestra	Mozart	Classical
cosi15_non.mid	Non siate ritrosi	Mozart	Classical
dgaria22.mid	Don Giovanni 22	Mozart	Classical
dongio04_madamina.mid	Madamina, il catalogo e questo	Mozart	Classical
gbp_serpina.mid	A Serpina penserete	Giovanni Battista Pergolesi	Classical
piano_concerto_449_1.mid	Piano Concerto 14 Allegro Vivace	Mozart	Classical
piano_sonata_330_1_(c)oguri.mid	Piano Sonata no. 10 Allegro	Mozart	Classical
piano_sonata_570_1_(c)oguri.mid	Piano Sonata no. 18 Allegro	Mozart	Classical
quartet_20_2_1_(c)simonetto.mid	String Quartet Op. 20 No. 2 Moderato	Haydn	Classical
quartet_20_6_1_(c)simonetto.mid	String Quartet Op. 20 No. 6 Allegro di molto	Haydn	Classical
quartet_33_3_2_(c)simonetto.mid	String Quartet Op. 33 No. 2 Scherzo	Haydn	Classical
quartet_33_6_2_(c)simonetto.mid	String Quartet Op. 33 No. 6 Andante	Haydn	Classical
sonata_17_(c)izumi.mid	Sonata 17 for harpsichord and guitar	Soler	Classical
sonata_19_1_(c)iscenko.mid	Piao Sonata Non 19 Adagio	Haydn	Classical
sonata_4_2_(c)iscenko.mid	Piano Sonata No. 4 Menuetto	Haydn	Classical
symphony_088_2_(c)edwards.mid	Symphony No. 88 Largo	Haydn	Classical
symphony_092_1_(c)edwards.mid	Symphony No. 92 Adagio	Haydn	Classical
symphony_183_2_(c)ishii.mid	Symphony 25 Andante	Mozart	Classical
symphony_35_385_3_(c)cvikl.mid	Symphony 35 Trio	Mozart	Classical
symphony_41_551_3_(c)cvikl.mid	Symphony 41 Menuetto	Mozart	Classical
symphony_94_3_(c)pajares.mid	Symphony 94 Trio	Haydn	Classical
wam_una_donna.mid	Una donna a quindici anni	Mozart	Classical
Achy_Breaky_Heart.mid	Achy Breaky Heart	Billy Ray Cyrus	Contemporary Country
Aint_Goin_Down.mid	Aint Goin Down	Garth Brooks	Contemporary Country
Always_On_My_Mind.mid	Always on my Mind	Willie Nelson	Contemporary Country
Amarillo_By_Morning.mid	Amarillo by Morning	George Strait	Contemporary Country
Believe_Me_Baby_I_Lied.mid	Believe Me Baby I Lied	Trisha Yearwood	Contemporary Country
Boot_Scootin_Boogie.mid	Boot Scootin Boogie	Brooks and Dunn	Contemporary Country
crazy1.mid	Crazy	Patsy Cline	Contemporary Country
Cross_My_Heart.mid	Cross my Heart	George Strait	Contemporary Country
Friends_In_Low_Places.mid	Friends in Low Places	Garth Brooks	Contemporary Country
helpmethrunight.mid	Help Me Thru the Night	Joe Walsh	Contemporary Country
I_Can_Love_You_Better.mid	I Can Love You Better	Dixie Chicks	Contemporary Country
I_Like_It_I_Love_It.mid	I Like it I Love It	Tim McGraw	Contemporary Country
IJustWantToDanceWithYou.mid	I Just Want to Dance With You	George Strait	Contemporary Country
istherelifeoutthere.mid	Is There Life Out There	Reba McEntire	Contemporary Country
Love_Gets_Me_Every_Time.mid	Love Gets me Every Time	Shania Twain	Contemporary Country
Never_Again_Again.mid	Never Again Again	Lee Ann Womack	Contemporary Country
One_More_Last_Chance.mid	One More Last Chance	Vince Gill	Contemporary Country
shaniatwain_anymanofmine.mid	Any Man of Mine	Shania Twain	Contemporary Country
Strawberry_Wine.mid	Strawberry Wine	Deanna Carter	Contemporary Country
Sweet_Home_Alabama.mid	Sweet Home Alabama	Lynyrd Skynyrd	Contemporary Country
The_Woman_In_Me.mid	The Woman in Me	Shania Twain	Contemporary Country
Theres_Your_Trouble.mid	Theres Your Trouble	Dixie Chicks	Contemporary Country
Two_Pina_Coladas.mid	Two Pina Coladas	Garth Brooks	Contemporary Country
Willin.mid	Willin	Little Feat	Contemporary Country
You_Win_My_Love.mid	You Win My Love	Shania Twain	Contemporary Country
81.mid	81	Miles Davis	Cool
acbetty.mid	Along Came Betty	Bennie Golson	Cool
afroblue.mid	Afro-Blue	John Coletrane	Cool
allblues.mid	All Blues	Miles Davies	Cool
bagsgroove.mid	Bag's Groove	Modern Jazz Quartet	Cool
Berniestune.mid	Bernie's Tune	Bernie Miller	Cool
blackdm.mid	Black Diamond	Bill Evans	Cool
bluetrain.mid	Blue Train	John Coletrane	Cool
bluette.mid	Bluette	Dave Brubeck	Cool
blungrn.mid	Blue in Green	Miles Davis	Cool
bodysoul.mid	Body and Soul	John Coletrane	Cool
cpw.mid	Central Park West	John Coletrane	Cool
four.mid	Four	Miles Davis	Cool
goodbait.mid	Good Bait	Tadd Dameron	Cool
greendol.mid	Green Dolphin Street	Miles Davis	Cool
I_Wont_Dance_R.mid	I Won't Dance	Anonymous	Cool
israel.mid	Israel	Miles Davis	Cool
ithought.mid	I Thought About You	Errol Garner	Cool
joyspring.mid	Joyspring	Clifford Brown	Cool
lullaby.mid	Lullaby of Birdland	George Shearing	Cool
myfunny.mid	My Funny Valentine	Miles Davis	Cool
nardis.mid	Nardis	Miles Davis	Cool
rndmngt.mid	Round Midnight	Thelonious Monk	Cool
take5b.mid	Take 5	Dave Brubeck	Cool
youdbe.mid	You'd be so Nice to Come Home To	Anonymous	Cool
bigroadblues_clifford.mid	Big Road Blues	Tommy Johnson	Country Blues
blindlemonjefferson_matchboxblues_clifford.mid	Matchbox Blues	Blind Lemon Jefferson	Country Blues
BlooZinay.mid	Blooz in A	Anonymous	Country Blues
byebyeblues_clifford.mid	Bye Bye Blues	Tommy Johnson	Country Blues
ChumpmanBlues.mid	Chumpman Blues	Anonymous	Country Blues
crossroadblues01_clifford.mid	Crossroad Blues	Robert Johnson	Country Blues
DeadMan.mid	Dead Man	Anonymous	Country Blues
DinahWashington-TroubleInMind.mid	Trouble in Mind	Dinah Washington	Country Blues
DownTowStomp.mid	Down Tow Stomp	Anonymous	Country Blues
gentleblues_natebray_mando.mid	Gentle Blues	Nate Bray	Country Blues
hardtimekillinfloor_clifford.mid	Hard Time Killin' Floor	Skip James	Country Blues
howlongblues_gp.mid	How Long Blues	Leroy Carr	Country Blues
intheevening.mid	In the Evening	Anonymous	Country Blues
josephspence_gloryglory_clifford.mid	Glory Glory	Joseph Spence	Country Blues
MississippiBlues.mid	Mississippi Blues	Anonymous	Country Blues
rollin_and_tumblin.mid	Rollin' and Tumblin'	Eric Clapton	Country Blues
screaminandhollerintheblues_clifford.mid	Screamin' and Hollerin' the Blues	Charlie Patton	Country Blues
skipjames_specialriderblues_clifford.mid	Special Rider Blues	Skip James	Country Blues
SugarBabe.mid	Sugar Babe	Anonymous	Country Blues
SugarMama.mid	Sugar Mama	Anonymous	Country Blues
terraplaneblues_clifford.mid	Terraplane Blues	Robert Johnson	Country Blues
walkinblues_clifford_gp.mid	Walkin' Blues	Robert Johnson	Country Blues
whatsthematterwiththemill_clifford.mid	What's the Matter With the Mill	Memphis Minnie	Country Blues
winter_johnny_dallas_clifford.mid	Dallas	Joshnny Winter	Country Blues
yahzoobasinboogie_clifford_gp.mid	Yahzoo Basin Boogie	Stephan Grossman	Country Blues
another.mid	Another Day in Paradise	Phil Colins	Dance Pop
aqua-barbie_girl.mid	Barbie Girl	Aqua	Dance Pop
Be_With_You_enrique_iglesias.mid	Be With You	Enrique Iglesias	Dance Pop
billiejn.mid	Billie Jean	Michael Jackson	Dance Pop
britney_spears_oops_i_did_it_again.mid	Oops I did it Again	Britney Spears	Dance Pop
britney_spears_stronger.mid	Stronger	Britney Spears	Dance Pop
celebrate.mid	Celebration	Kool and the Gang	Dance Pop
dancing.mid	You Should be Dancing	Beegees	Dance Pop
everybody.mid	Everybody	Backstreet Boys	Dance Pop
foxbabe.mid	Foxy Babe	Anonymous	Dance Pop
g-goyf.mid	Get on your Feet	Gloria Estefan	Dance Pop
kc-band.mid	That's the Way	KC and the Sunshine Band	Dance Pop
m_people-moving_on_up.mid	Moving On Up	M People	Dance Pop
makeit.mid	Make it Happen	Mariah Carey	Dance Pop
my_destiny.mid	My Destiny	Lionel Ritchie	Dance Pop
nowthat.mid	Now That I Know	Mariah Carey	Dance Pop
oppatt.mid	Opposites Attract	Paula Abdul	Dance Pop
raylight.mid	Ray of Light	Madonna	Dance Pop
somehap.mid	Something Happened	Phil Collins	Dance Pop
spice.mid	Spice up your Life	Spice Girls	Dance Pop
villagepeople_machoman.mid	Macho Man	Village People	Dance Pop
waterloo.mid	Waterloo	ABBA	Dance Pop
whosgirl.mid	Who's that Girl	Madonna	Dance Pop
whothink.mid	Who do you Think you Are	Spice Girls	Dance Pop
YMCA.mid	YMCA	Village People	Dance Pop
alegriasdemofagen.mid	Alegrias de Mofa	Mel Agen	Flamenco
buleriaA.mid	Blulerias	Jose Martin Albo	Flamenco
caprichodehuelvaser.mid	Capricho de Huelva	Juan Serrano	Flamenco
espejal.mid	Espejo Malagueno	J M Albo	Flamenco
falsetigle.mid	Falsetas	Angel Iglesias	Flamenco
fandangh.mid	Fandango	Maravilla Luis	Flamenco
fandangobe.mid	Fandango	S Behrend	Flamenco
fandangosdehuelvajg.mid	Fandangos de Huelva	Juan de Grecos	Flamenco
fantasiab.mid	Fantasia	Bielsa Valentin	Flamenco
farrucaporrumferr.mid	Farruca	Manuel Ferre	Flamenco
fiestaenlacruzdemayomar.mid	Fiesta en la Cruz de Mayo	Luis Maravilla	Flamenco
lachungamo.mid	La Chunga	M Monreal	Flamenco
llorafarruca.mid	Llora farruca	V M Serranito	Flamenco
Lucia_Rio_Ancho.mid	Rio Ancho	Pace de Lucia	Flamenco
malagueno.mid	Malagueno	Ortega Blanco	Flamenco
Paco_de_Lucia_Guajiras_Lucia.mid	Guajiras Lucia	Paco de Lucia	Flamenco
Paco_de_Lucia_Los_Pinares.mid	Los Pinares	Pace de Lucia	Flamenco
Peteneraci.mid	Peteneraci	M Cimadevilla	Flamenco
raicesgitanasbat.mid	Raices gitanas	Andres Batista	Flamenco
raizflamenal.mid	Raiz flamenca	J M Albo	Flamenco
Sabicas_Delicada.mid	Delicada	Sagreras	Flamenco
Sabicas_Fandangos.mid	Fandanguos de Huelva	Sagreras	Flamenco
sevillanasga.mid	Sevillanas	Patricio Galindo	Flamenco
TOQUE_POR_TIENTOS.mid	Tientos	Maravilla Luis	Flamenco
zorongove.mid	Zorongo	Velaso Venacio Garcia	Flamenco
anyway.mid	Do it Any Way You Wanna	People's Choice	Funk
a real mother for ya.mid	A Real Mother For Ya	Johnny Guitar Watson	Funk
BOOKER_T___THE_MGs_HIP_HUGGER.mid	Hip Hugger	Booker T and the MGs	Funk
Brick house.mid	Brick House	Commodores	Funk
chameleon.mid	Chameleon	Herbie Hancock	Funk
Cissy Strut.mid	Cissy Strut	Meters	Funk
cut the cake.mid	Cut the Cake	Average White Band	Funk
funct_u.mid	Funct U	Anonymous	Funk
give it up or turn it loose.mid	Give it Up or Turn it Loose	James Brown	Funk
Hot pants.mid	Hot Pants	James Brown	Funk
it's your thing.mid	It's Your Thing	Isley Brothers	Funk
JAMES_BROWN_COLD_SWEAT.mid	Cold Sweat	James Brown	Funk
JAMES_BROWN_I_GOT_THE_FEELIN_.mid	I Got the Feelin'	James Brown	Funk
JAMES_BROWN_SEX_MACHINE.mid	Sex Machine	James Brown	Funk
james_brown-i_feel_good.mid	I Feel Good	James Brown	Funk
james_brown-papas_got.mid	Papa's got a Brand New Bag	James Brown	Funk
JUNGLE_BOOGIE.mid	Jungle Boogie	Kool and the Gang	Funk
Last Night The DJ Saved My Life.mid	Last Night a DJ Saved my Life	Indeep	Funk
out of sight.mid	Out of Sight	James Brown	Funk
play that funky music.mid	Play that Funky Music	Wild Cherry	Funk
RufusThomas-WalkingTheDog.mid	Walking the Dog	Rufus Thomas	Funk
sexy MF.mid	Sexy MF	Prince	Funk
SHOT_GUN.mid	Shotgun	Junior Walker and the All Stars	Funk
thank you for letting me be mice elf.mid	Thank You For Letting Me Be Myself	Sly and the Family Stone	Funk
Why did you do it.mid	Why Did You Do It	Stretch	Funk
[youngbleed]-howyadodat.mid	How Ya Do Dat	Young Blood	Hardcore Rap
Aint_Nothing_Personal.mid	Ain't Nothin Personal	Snoop Dog	Hardcore Rap
Bad_Meets_Evil.mid	Bad Meets Evil	Eminem	Hardcore Rap
Big_Pimpin.mid	Big Pimpin	Jay Z	Hardcore Rap
bowdown.mid	Bow Down	Westside Connection	Hardcore Rap
dadip.mid	Da Dip	Freak Nasty	Hardcore Rap
First_Of_The_Month.mid	First of the Month	Bone Thugs N Harmony	Hardcore Rap
Forgot_About_Dre.mid	Forgot About Dre	Dr. Dre	Hardcore Rap
Gangstas_Paradise.mid	Gangstas Paradise	Coolio	Hardcore Rap
Ghetto_Vet.mid	Ghetto Vet	Ice Cube	Hardcore Rap
gsandhustlas.mid	G's and Hustlas	Snoop Dog	Hardcore Rap
g-thang.mid	G Thang	Snoop Dog and Dr. Dre	Hardcore Rap
Guilty_Conscience.mid	Guilty Conscience	Eminem	Hardcore Rap
icecube_recordcompanypimpin.mid	Record Company Pimpin'	Ice Cube	Hardcore Rap
igotfiveonit.mid	I Got Five on It	The Luniz	Hardcore Rap
Keep_Their_Heads_Ringing.mid	Keep Their Heads Ringing	Dr. Dre	Hardcore Rap
Look_Into_My_Eyes.mid	Look Into My Eyes	Bone Thugs N Harmony	Hardcore Rap
Murder_Was_The_Case.mid	Murder was the Case	Snoop Dog	Hardcore Rap
Notorious_Thugs.mid	Notorious Thugs	Notorious B.I.G.	Hardcore Rap
Still_Dre.mid	Still Dre	Dr. Dre	Hardcore Rap
The_Real_Slim_Shady.mid	The Real Slim Shady	Eminem	Hardcore Rap
The_Shiznit.mid	The Shiznit	Snoop Dog	Hardcore Rap
tupacshakur_2ofamericazmostwanted.mid	2 of Americaz Most Wanted	Tupac Shakur	Hardcore Rap
warreng_iwantitall.mid	I Want it All	Warren G	Hardcore Rap
Whoa.mid	Whoa	Black Rob	Hardcore Rap
ain't_talkin_bout_love.mid	Ain't Talkin' About Love	Van Halen	Hard Rock
AliceCooper_Elected.mid	Elected	Alice Cooper	Hard Rock
animal.mid	Animal	Def Leppard	Hard Rock
boys_are_back.mid	Boys are Back	Bon Jovi	Hard Rock
dreams.mid	Dreams	Unknown	Hard Rock
FALLLOVE.MID	Falling in Love is Hard on the Knees	Aerosmith	Hard Rock
gimme_all_your_lovin.mid	Gimme All Your Lovin'	ZZ Top	Hard Rock
gimmesh.mid	Gimme Shelter	Rolling Stones	Hard Rock
go_again.mid	Here I go Again	Whitesnake	Hard Rock
heaven_is.mid	Heaven Is	Def Leppard	Hard Rock
hysteria.mid	Hysteria	Def Leppard	Hard Rock
Iron_Man.mid	Iron Man	Black Sabbath	Hard Rock
kravitz-are_you_gonna_go_my_way.mid	Are You Gonna Go My Way	Lenny Kravitz	Hard Rock
lazy.mid	Lazy	Deep Purple	Hard Rock
paradise_city.mid	Paradise City	Guns and Roses	Hard Rock
Paranoid.mid	Paranoid	Black Sabbath	Hard Rock
photograph.mid	Photograph	Def Leppard	Hard Rock
rightnow.mid	Right Now	Van Halen	Hard Rock
schlsout.mid	School's Out	Alice Cooper	Hard Rock
smoke.mid	Smoke on the Water	Deep Purple	Hard Rock
start.mid	Start Me Up	Rolling Stones	Hard Rock
sweetem.mid	Sweet Emotion	Aerosmith	Hard Rock
van_halen-jump.mid	Jump	Van Halen	Hard Rock
wedding.mid	White Wedding	Billy Idol	Hard Rock
you_give_love_a_bad_name.mid	You Give Love a Bad Name	Bon Jovi	Hard Rock
7thst.mid	7th Street	Robert Cote	Jazz Soul
BigMess.mid	Big Mess	Anonymous	Jazz Soul
Blowin' Smoke.mid	Blowin' Smoke	Anonymous	Jazz Soul
bluejam.mid	Blues Jam	Anonymous	Jazz Soul
bluesy.mid	Bluesy	Anonymous	Jazz Soul
bolivar.mid	Ba-lue Bolivar Blues	Thelonious Monk	Jazz Soul
BORGAN_Lues.mid	Borgan Lues	Anonymous	Jazz Soul
Chicken_Shack.mid	Chicken Shack	Jimmy Smith	Jazz Soul
chicken.mid	Chicken	Jaco Pastorius	Jazz Soul
cjam.mid	C Jam Blues	Oscar Peterson	Jazz Soul
comehome.mid	Comin' Home Baby	Herbie Mann	Jazz Soul
Count_On_The_Blues.mid	Count on the Blues	Count Basie	Jazz Soul
deadend.mid	Dead End	Anonymous	Jazz Soul
doxy.mid	Doxy	Sonny Rollins	Jazz Soul
egblues.mid	EG Blues	Mezzoforte	Jazz Soul
filthy.mid	Filthy McNasty	Horace Silver	Jazz Soul
homeinsa.mid	Homes in Alabama	Robert Martin	Jazz Soul
Just Blues.mid	Just Blues	Anonymous	Jazz Soul
lope-isl.mid	Cantilope Island	Herbie Hancock	Jazz Soul
moanin.mid	Moanin'	Bobby Timmons	Jazz Soul
OpFunk.mid	Opus De Funk	Horace Silver	Jazz Soul
ppanther_37.mid	Pink Panther Theme	Anonymous	Jazz Soul
sidewinder.mid	Sidewinder	Lee Morgan	Jazz Soul
The On-Line Boogie.mid	The On-Line Boogie	Anonymous	Jazz Soul
watrmeln.mid	Watermelon Man	Herbie Hancock	Jazz Soul
allepsaa.mid	Alle psallite Alleluia	Anonymous	Medieval
angelus.mid	Angelus Ad Virginem	Anonymous	Medieval
anglvirm.mid	Angelus ad virginem	Anonymous	Medieval
belfiore.mid	Bel fiore danca	Anonymous	Medieval
conductu.mid	Conductus	Anonymous	Medieval
czaldy.mid	Czaldy Waldy	Anonymous	Medieval
ductia.mid	Ductia	Anonymous	Medieval
eraraute.mid	Au tems pascor	Jehan Erars	Medieval
estamp02.mid	Estampie 13th cent	Anonymous	Medieval
estamp4.mid	La quarte estampie royal	Anonymous	Medieval
hallfima.mid	Fi maris de vostre amour	Adam de la Halle	Medieval
hen4sanc.mid	Sanctus	Henry Lancaster	Medieval
icumen.mid	Summer is icumen in	Anonymous	Medieval
jeurobin.mid	Song from Le Jeu de Robin et Marion	Adam de la Halle	Medieval
kalenda.mid	Kalenda Maya	Raimbaut de Vaiqueras	Medieval
la_rotta.mid	La Rotta	Anonymous	Medieval
lndnchip.mid	Chi piu vuol sapere	Francesco Lanidini	Medieval
lndnpart.mid	Partesi con dolore	Francesco Lanidini	Medieval
lndnques.mid	Questa fanciull' amor	Francesco Lanidini	Medieval
machbont.mid	De bonte, de valour	Guillaume de Machaut	Medieval
machdous.mid	Dous amis	Guillaume de Machaut	Medieval
machmaag.mid	Mass: Agnus	Guillaume de Machaut	Medieval
omniscur.mid	Omnis curet homo	Anonymous	Medieval
peroalna.mid	Alleluya: Nativitas	Perotin	Medieval
saltare2.mid	Saltarello 2	Anonymous	Medieval
99_ways_to_die.mid	99 Ways to Die	Megadeth	Metal
aces_high.mid	Aces High	Iron Maiden	Metal
Beautiful_People.mid	Beautiful People	Marilyn Manson	Metal
Becoming.mid	Becoming	Pantera	Metal
BLACK.MID	Black Sunshine	White Zombie	Metal
Break_Stuff.mid	Break Stuff	Limp Bizkit	Metal
Bulls_On_Parade.mid	Bulls on Parade	Rage Against the Machine	Metal
codding_town.mid	Codding Town	Primus	Metal
Cowboys_From_Hell.mid	Cowboys From Hell	Pantera	Metal
Dose.mid	Dose	Filter	Metal
Down.mid	Down	311	Metal
Dragula.mid	Dragula	Rob Zombie	Metal
Guerilla_Radio.mid	Guerilla Radio	Rage Against the Machine	Metal
hit_the_lights.mid	Hit the Lights	Metallica	Metal
i'm_broken.mid	I'm Broken	Pantera	Metal
irresponsible_hate_anthem.mid	Irresponsible Hate Anthem	Marilyn Manson	Metal
Killing_In_The_Name_Of.mid	Killing in the Name Of	Rage Against the Machine	Metal
Know_Your_Enemy.mid	Know Your Enemy	Rage Against the Machine	Metal
MASTER_O.MID	Master of Puppets	Metallica	Metal
revelations.mid	Revelations	Iron Maiden	Metal
temple_of_the_bull.mid	Temple of the Bull	Whilte Zombie	Metal
the_four_horsemen.mid	The Four Horsemen	Metallica	Metal
the_shortest_straw.mid	The Shortest Straw	Metallica	Metal
through_the_never.mid	Through the Never	Metallica	Metal
Walk.mid	Walk	Pantera	Metal
435question.mid	The Unanswered Question	Ives	Modern Classical
57_1a_(c)bachovich.mid	Quintet in g minor for violins, viola, cello and piano, op. 57	Shostadovich	Modern Classical
73_3_(c)bachovich.mid	String Quartet 3 Mvmt 3	Shostakovich	Modern Classical
87-15b.mid	Fugue no. 15 for piano, op. 87	Shostakovich	Modern Classical
bartok_sonata3.mid	Sonata 3	Bartok	Modern Classical
copmw.mid	Concerto	Copland	Modern Classical
deb3.mid	Les fees sont d'exquises danseuses	Debussy	Modern Classical
deb5.mid	l'apresmidi d'un faune	Debussy	Modern Classical
firebird.mid	Firebird	Stravinski	Modern Classical
grecque1.mid	Greque	Maurice Ravel	Modern Classical
hindemithrag.mid	Sonata II	Hindemith	Modern Classical
Mouvement_1.mid	Symphonie de Psaumes 1	Stravinski	Modern Classical
prokofievSymph52.mid	Symphony No. 5	Prokofiev	Modern Classical
r1t.mid	Valses Nobles et Sentimentales	Maurice Ravel	Modern Classical
satsara2.mid	Sarabande No.2	Erik Satie	Modern Classical
schoenberg_6stucke2.mid	Sechs Kleine	Schoenberg	Modern Classical
Schoenberg_op33a.mid	Op. 33 a	Schoenberg	Modern Classical
schoskk6.mid	Sechs Kleine Klavierstucke 6	Schoenberg	Modern Classical
sjostakovitsj_melancholie.mid	Melancholie	Shostakovich	Modern Classical
Stockhausen_StarSigns.mid	Star Sign	Stockhausen	Modern Classical
Suite_1.mid	Suite Opus 14	Bartok	Modern Classical
Webern_Aufblick.mid	Aufblick	Webern	Modern Classical
webern_op28b.mid	Opus 28b	Webern	Modern Classical
webern_sym1_cmc.mid	1st mvmt, Symphony (Op.21)	Webern	Modern Classical
wrong-Bartok_all3.mid	Wrong	Bartok	Modern Classical
beenaroundtheworld.mid	Been Around the World	Puff Daddy	Pop Rap
Big_Poppa.mid	Big Poppa	Notorious B.I.G.	Pop Rap
C_U_When_U_Get_There.mid	C U When U Get There	Coolio	Pop Rap
Changes.mid	Changes	Tupac Shakur	Pop Rap
Country_Grammar.mid	Country Grammar	Nelly	Pop Rap
everyday_people.mid	Everyday People	Arrested Development	Pop Rap
fanvoy.mid	Fantastic Voyage	Coolio	Pop Rap
Gettin_Jiggy_With_It.mid	Gettin' Jiggy With It	Will Smith	Pop Rap
Hey_Lover.mid	Hey Lover	LL Cool J	Pop Rap
I_Got_The_Hook_Up.mid	I Got the Hook Up	Master P	Pop Rap
iaintmad.mid	I Aint Mad Atcha	Tupac Shakur	Pop Rap
Ill_Be_Missing_You.mid	I'll Be Missing You	Puff Daddy	Pop Rap
iwish.mid	I Wish	Skee-Lo	Pop Rap
Jamboree.mid	Jamboree	Naughty By Nature	Pop Rap
Just_The_Two_Of_Us.mid	Just the Two of Us	Will Smith	Pop Rap
Men_In_Black.mid	Men in Black	Will Smith	Pop Rap
Mo_Money_Mo_Problems.mid	Mo Money Mo Problems	Puff Daddy	Pop Rap
One_More_Chance.mid	One More Chance	Notorious B.I.G.	Pop Rap
Party_Up.mid	Party Up	DMX	Pop Rap
regulate.mid	Regulate	Warren G	Pop Rap
returnofthemack.mid	Return of the Mack	Mark Morrison	Pop Rap
Stan.mid	Stan	Eminem	Pop Rap
U_Cant_Touch_This.mid	U Can't Touch This	MC Hammer	Pop Rap
what's_love_got_do_with_it.mid	What's Love Got to do With It	Warren G	Pop Rap
youmakemewanna.mid	You Make Me Wanna	Usher	Pop Rap
20th_century_fox.mid	20th Century Fox	Doors	Psychedelic
AllmanBrothers-BlueSky.mid	Blue Sky	Allman Brothers Band	Psychedelic
AllmanBrothers-InMemoryOfElizabethReedUnplugged.mid	In Memory of Elizabeth Reed	Allman Brothers Band	Psychedelic
AllmanBrothers-WhippingPost.mid	Whipping Post	Allman Brothers Band	Psychedelic
another_brick_in_the_wall.mid	Another Brick in the Wall	Pink Floyd	Psychedelic
bad_love.mid	Bad Love	Eric Clapton	Psychedelic
badge.mid	Badge	Cream	Psychedelic
Break_On_Through_Doors.mid	Break on Through to the Other Side	Doors	Psychedelic
clapton-layla.mid	Layla	Derek and the Dominoes	Psychedelic
Cream_StrangeBrew.mid	Strange Brew	Cream	Psychedelic
EricClapton-SunshineOfYourLove.mid	Sunshine of Your Love	Cream	Psychedelic
heyjoe.mid	Hey Joe	Jimi Hendrix	Psychedelic
house.mid	House of the Rising Son	Animals	Psychedelic
JEFFERSON_AIRPLANE__White_Rabbit.mid	White Rabbit	Jefferson Airpline	Psychedelic
light_my_fire.mid	Light My Fire	Doors	Psychedelic
mistymountainhop.mid	Misty Mountain Hop	Led Zeppelin	Psychedelic
purple_haze.mid	Purple Haze	Jimi Hendrix	Psychedelic
riders.mid	Riders on the Storm	Doors	Psychedelic
santana-blackmagicwoman.mid	Black Magic Woman	Santana	Psychedelic
shesnot.mid	She's Not There	The Zombies	Psychedelic
smooth.mid	Smooth	Santana	Psychedelic
southern.mid	Southern Man	Neil Young	Psychedelic
stairway_to_heaven.mid	Stairway to Heaven	Led Zeppelin	Psychedelic
voodoo_chile.mid	Voodoo Chile	Jimi Hendrix	Psychedelic
white_room.mid	White Room	Cream	Psychedelic
86.mid	86	Green Day	Punk
A-D-D.mid	A-D-D	Ten Foot Pole	Punk
All_The_Small_Things.mid	All the Small Things	Blink 182	Punk
AWALK.MID	A Walk	Bad Religion	Punk
Beat_On_The_Brat.mid	Beat on the Brat	Ramones	Punk
Blitzkrieg_Bop.mid	Blitzkrieg Pop	Ramones	Punk
Bombshell.mid	Bombshell	Operation Ivy	Punk
College_Full.mid	College Full	Blink 182	Punk
Doin_Time.mid	Doin Time	MXPX	Punk
Drugs_Are_Good.mid	Drugs are Good	NoFX	Punk
greenday_jaded.mid	Jaded	Green Day	Punk
Happy_Guy.mid	Happy Guy	NoFX	Punk
Hobophobic.mid	Hobophobic	NoFX	Punk
Knowledge.mid	Knowledge	Operation Ivy	Punk
Mable.mid	Goldfinger	Mable	Punk
nofx-don't_call_me_white.mid	Don't Call Me White	NOFX	Punk
nra-she's_driving.mid	She's Driving	NRA	Punk
propagandhi-anti-manifesto.mid	Anti Manifesto	Propagandhi	Punk
Punk_Rawk_Show.mid	Punk Rawk Show	MXPX	Punk
Ruby_Soho.mid	Ruby Soho	Rancid	Punk
screeching_weasel-dirty_needles.mid	Dirty Needles	Screeching Weasel	Punk
Silly_Thing.mid	Silly Thing	Sex Pistols	Punk
teen_idols-ketchup_soup.mid	Ketchup Soup	Teen Idols	Punk
the_offspring-hand_grenades.mid	Hand Grenade	Offspring	Punk
What_If_I.mid	What If	Pennywise	Punk
cascades_(c)simonetto.mid	Cascades	Anonymous	Ragtime
climax.mid	Climax Rag	Joseph Lamb	Ragtime
dnjazzme.mid	Don't Jazz me	Joseph Lamb	Ragtime
entrtanr.mid	The Entertainer	Scott Joplin	Ragtime
figleaf.mid	Fig Leaf Rag	Scott Joplin	Ragtime
fizzwatr.mid	Fizz Water	James Hubert Blake	Ragtime
froglegs.mid	Frog Legs Rag	James Scott	Ragtime
gracebty.mid	Grace and Beauty	James Scott	Ragtime
heliotro.mid	Heliotrope Bouquet	Scott Joplin	Ragtime
hilarity.mid	Hilarity Rag	James Scott	Ragtime
kinklets.mid	Kinklets	Arthur Marsall	Ragtime
kssngbug.mid	Kissing Bug Rag	Charles Johnson	Ragtime
magnolia.mid	Magnolia Rag	Gary Davis	Ragtime
maple.mid	Maple Leaf Rag	Scott Joplin	Ragtime
nonparel.mid	The Nonpareil	Scott Joplin	Ragtime
original_rags_(c)simonetto.mid	Original Rags	Carl Hoffman	Ragtime
peacherine_rag_(c)simonetto.mid	Peacherine	Anonymous	Ragtime
ragntngl.mid	Ragtime Nightingale	Joseph Lamb	Ragtime
reindeer.mid	Reindeer Rag	Joseph Lamb	Ragtime
sensaton.mid	Sensation Rag	Joseph Lamb	Ragtime
sunburst.mid	Sunburst Rag	James Scott	Ragtime
sunflowr.mid	Sunflower Slow Drag	Scott Joplin	Ragtime
swipesy.mid	Swipesy	Scott Joplin	Ragtime
topliner.mid	Top Liner Rag	Joseph Lamb	Ragtime
whiskrow.mid	Whiskey Row Rag	Gary Davis	Ragtime
blazers.mid	Blazers	M. E. Dread	Reggae
cant help falling in love.mid	Can't Help Falling in Love	UB-40	Reggae
crazy_reg.mid	Crazy	M. E. Dread	Reggae
d-allthatshewants.mid	All That She Wants	Ace of Base	Reggae
d-cocojamboo.mid	Cocojamboo	Anonymous	Reggae
etude.mid	Regatude	M. E. Dread	Reggae
fivemil1.mid	Five Million	Anonymous	Reggae
gamespeopleplay.mid	Games People Play	Inner Circle	Reggae
here i am baby.mid	Here I Am Baby	UB-40	Reggae
jahlive.mid	Jah Live	Bob Marley	Reggae
jbgood_r.mid	Johnny B Goode	Peter Tosh	Reggae
marley-sherrif.mid	I Shot the Sheriff	Bob Marley	Reggae
master_blaster.mid	Master Blaster	Stevie Wonder	Reggae
may be tomorrow.mid	Maybe Tomorrow	UB-40	Reggae
naturalmystic.mid	Natural Mystic	Bob Marley	Reggae
redwine.mid	Red Wine	UB40	Reggae
REGGAE.mid	Reggae Jam	Anonymous	Reggae
reggaecouldyoubeloved.mid	Could You be Loved	Bob Marley	Reggae
ReggaeisthisLove.mid	Is This Love?	Bob Marley	Reggae
Reggaejammin.mid	Jammin	Bob Marley	Reggae
rootcult.mid	Roots Culture	Anonymous	Reggae
sweat01.mid	Sweat	Inner Circle	Reggae
tomorrowpeople.mid	Tomorrow People	Ziggy Marley	Reggae
waitinginvain.mid	Waiting in Vain	Bob Marley	Reggae
zimbabwe.mid	Zimbabwe	Bob Marley	Reggae
allw_cp3.mid	Claro Pascali Gaudio	Richard Allwood	Renaissance
Amor_vittorioso.mid	Amor vittorioso	Giovanni Gastoldi	Renaissance
despafm.mid	Absalon, Fili Mi	Josquin des Prez	Renaissance
despavv.mid	Ave vera virginitas	Josquin des Prez	Renaissance
despdpc.mid	De Profundis Clamavi	Josquin des Prez	Renaissance
despeie.mid	Et incarnatus est	Josquin des Prez	Renaissance
despmpl.mid	Missa Pange Lingua	Josquin des Prez	Renaissance
dufaycas.mid	Conditur Alme Siderum	Guillaume Dufay	Renaissance
gabrcd.mid	Cantate Domino	Giovanni Gabrielli	Renaissance
idv_die_weiber.mid	Die weiber mit den flohen	Ivo de Vento	Renaissance
jns_bene.mid	Benedicam Domino	Robert Johnson	Renaissance
merulo2.mid	Toccata	Claudio Merulo	Renaissance
ock4up.mid	Canon in Epidiatesseron	Johannes Ockeghem	Renaissance
redf_glr.mid	Glorificamus	John Redford	Renaissance
Sing_we_and_chant_it.mid	Sing we and chant it	Thomas Morley	Renaissance
tall_sor.mid	When Shall my Sorrrowful Sighing Slack	Thomas Tallis	Renaissance
tallnom2.mid	In Nomine	Thomas Tallis	Renaissance
tav_nom.mid	In Nomine	John Redford	Renaissance
victomagnum.mid	O magnum mysterium	Victoria	Renaissance
victoquartiagnus2.mid	Agnus Dei	Victoria	Renaissance
victpang.mid	Pange Lingua	Victoria	Renaissance
wb_ye_sacred_muses.mid	Ye sacred muses	William Byrd	Renaissance
x_ol_lucia.mid	Lucia, celu, celu	Orlando di Lasso	Renaissance
x_ol_matona_mia_cara.mid	Matona mia cara	Orlando di Lasso	Renaissance
x_ol_un_jeune_moine.mid	Un jeune moine es sorti du couent	Orlando di Lasso	Renaissance
ab-johnny_b_goode.mid	Johnny be Good	Chuck Berry	Rock and Roll
ab-tutti_fruitti.mid	Tutti Frutti	Little Richard	Rock and Roll
around.mid	Around and Around	Chuck Berry	Rock and Roll
atthehop.mid	At the Hop	Anonymous	Rock and Roll
b00186.mid	House is Rocking	Stevie Ray Vaughn	Rock and Roll
b00287.mid	Sock Hop Boogie	Jerry Lee Lewis	Rock and Roll
boyp.mid	Big Boy Pete	Unknown	Rock and Roll
chanlace.mid	Chantilly Lace	Anonymous	Rock and Roll
dc-choochoochaboogie.mid	Ch Chu Boogie	Anonymous	Rock and Roll
dwb-ltsally.mid	Long Tall Sally	Anonymous	Rock and Roll
elvis_presley_all_shook_up.mid	All Shook Up	Elvis Presley	Rock and Roll
fun3.mid	Fun Fun Fun	Beach Boys	Rock and Roll
gboffire.mid	Great Balls of Fire	Jerry Lee Lewis	Rock and Roll
jailhouse.mid	Jailhouse Rock	Elvis Presley	Rock and Roll
LITTLE_RICHARD__Slippin_and_Slidin.mid	Slippin' and Slidin	Little Richard	Rock and Roll
No_Particular_Place.mid	No Particular Place to Go	Chuck Berry	Rock and Roll
ps-lucille.mid	Lucille	Little Richard	Rock and Roll
rebel.mid	Rebel	Anonymous	Rock and Roll
rolloverbeethoven.mid	Roll Over Beethoven	Chuck Berry	Rock and Roll
school.mid	School Days	Chuck Berry	Rock and Roll
shoes.mid	Blue Suede Shoes	Elvis Presley	Rock and Roll
surfin.mid	Surfin' USA	Beach Boys	Rock and Roll
Sweet_Little_Sixteen.mid	Sweet Little Sixteen	Chuch Berry	Rock and Roll
teddybea.mid	Teddy Bear	Anonymous	Rock and Roll
trouble.mid	Trouble	Elvis Presley	Rock and Roll
aida1_celeste.mid	Celeste Aida	Verdi	Romantic
aida2fin.mid	Aida, Finale du deuxieme acte	Verdi	Romantic
barber02_unavoce.mid	Una voce poco fa	Gioacchino Rossini	Romantic
beet4.mid	Fur Elise	Beethoven	Romantic
beet5.mid	Bagatelles, Op. 126, Allegro in G-	Beethoven	Romantic
berlioz_symfan_5.mid	Symponie Fantastique Mvmt 5	Berlioz	Romantic
Berlioz16.mid	Harold In Italy Op. 16	Berlioz	Romantic
Brahms-Rhapsody in G.mid	Rhapsody in G	Brahms	Romantic
cap07.mid	Capricho No 7	Paganini	Romantic
chop4.mid	Nocturne No.9 in B, Op.32 No.1	Chopin	Romantic
chop8.mid	Ballade No.3 in Ab, Op.47	Chopin	Romantic
dvorak_symphony_9_1l.mid	Symphony no.9 in e minor, Adagio	Dvorak	Romantic
eroica-1.mid	Eroica 1st Mvmt	Beethoven	Romantic
gianni2_omio.mid	O mio babbino caro	Giacomo Puccini	Romantic
liszt5.mid	Etude Transcendentales No.5	Liszt	Romantic
liszt7.mid	Concerto in Eb, 1st and 2nd Mov	Liszt	Romantic
lohengrin06_fernem.mid	In fernem Land	Wagner	Romantic
meistersinger11_prize.mid	Walter's Prize Song	Wagner	Romantic
Mendelssohn-AMidsummer-Overture.mid	A Midsummer Night's Dream Overture	Mendelssohn	Romantic
Mendelssohn-ViolinConcerto64-Alegro.mid	Violin Conerto 64 Alegro	Mendelssohn	Romantic
tr1101.mid	Trio para piano, violin y violoncello op.110 1er mov	Schumann	Romantic
trio66_1.mid	Trio para piano, violin y violoncello op.66, 1er mov	Mendelssohn	Romantic
vdreq21a.mid	Requiem, dies irae	Verdi	Romantic
wagn4.mid	Siegfried, Idyll	Wagner	Romantic
wagn8.mid	Ride of the Valkyrie	Wagner	Romantic
ahahohno.mid	Ah ah Oh No	Anonymous	Salsa
amorcomoelnuestro.mid	Amorcomoelnuestro	Anonymous	Salsa
BAILSAL.mid	Baila	Anonymous	Salsa
BRUJERIA.mid	Brujeria	Anonymous	Salsa
India.mid	India	Anonymous	Salsa
L2003_01.mid	Salsa 3	Anonymous	Salsa
L2003_03.mid	Salsa 5	Anonymous	Salsa
L2003_05.mid	Salsa 7	Anonymous	Salsa
L2003_08.mid	Salsa 10	Anonymous	Salsa
LA_SALSA.mid	La Salsa	Anonymous	Salsa
LLUVIA.mid	Lluvia	Anonymous	Salsa
Mambo_(Mambo_Mix).mid	Mambo Mix	Anonymous	Salsa
Morena.mid	Morena	Anonymous	Salsa
NOESTAS.mid	Si tu no estas	Anonymous	Salsa
Periodico.mid	Periodico	Anonymous	Salsa
PUENTE.mid	Puente	Anonymous	Salsa
Salsa_(Gilberto_SantaRosa)_(Amor_mio_no_te_vayas).mid	Amor Mio No Te Vayas	Gilberto Rosa	Salsa
Salsa_(Gilberto_SantaRosa)_(Dime_Cuando).mid	Dime Cuando	Gilberto Rosa	Salsa
Salsa_(La_Negra_Tomasa).mid	La Negra Tomas	Anonymous	Salsa
salsa_salsa.mid	Salsa	Anonymous	Salsa
salsa.mid	Salsa 1	Anonymous	Salsa
sinquere.mid	Sin Quere	Anonymous	Salsa
siunavez.mid	Si Una Vez-Selena	Anonymous	Salsa
TUMQUEMA.mid	Tu me quemas	Anonymous	Salsa
TuNoLeAmas.mid	Tu no le amas	Anonymous	Salsa
angelaonmymind.mid	Angela on my Mind	George Benson	Smooth Jazz
atIknew.mid	And Then I Knew	Pat Metheney	Smooth Jazz
birdland.mid	Birdland	Joe Zawinul	Smooth Jazz
breezin.mid	Breezin	George Benson	Smooth Jazz
chestnuts.mid	The Christmas Song	Mel Torme	Smooth Jazz
chillout.mid	Chill Out	Anonymous	Smooth Jazz
CleanSweep.mid	Clean Sweep	Bobby Broom	Smooth Jazz
cloudwh.mid	Cloud Whisper	Bernie Gunn	Smooth Jazz
earlyam.mid	Early AM	Anonymous	Smooth Jazz
freedom.mid	Freedom Dance	David Benoit	Smooth Jazz
hangin.mid	Hangin'	Anonymous	Smooth Jazz
ldsummer.mid	Last Day of Summer	Eric Marienthal	Smooth Jazz
louis_armstrong-all_the_time_in_the_world.mid	We Have all the Time in the World	Louis Armstrong	Smooth Jazz
lovebetrayed.mid	Love Betrayed	Anonymous	Smooth Jazz
lowdown.mid	Lowdown	Anonymous	Smooth Jazz
maputo.mid	Maputo	David Sanborn	Smooth Jazz
mywish.mid	Piece of My Wish	Dave Koz	Smooth Jazz
Nitefunk.mid	NiteFunk	Anonymous	Smooth Jazz
notgoodenough.mid	Not Good Enough	Anonymous	Smooth Jazz
nothingsgonnachangemylove-georgebenson.mid	Nothing's Gonna Change my Love	George Benson	Smooth Jazz
rememberourgoodtimes.mid	Remember Our Good Times	Anonymous	Smooth Jazz
rnbxg.mid	rnbxg	Anonymous	Smooth Jazz
sunflower.mid	Little Sunflower	Freddie Hubbard	Smooth Jazz
turnlove.mid	Turn Your Love Around	George Benson	Smooth Jazz
u_smile.mid	You Make Me Smile	Dave Koz	Smooth Jazz
020-sati.mid	I Can't Get No Satisfaction	Rolling Stones	Soul
AT_THE_CLUB.mid	At the Club	Drifters	Soul
BEN_E_KING_DON_T_PLAY_THAT_SONG__YOU_LIED_.mid	Don't Play that Song	Ben E. King	Soul
BEN_E_KING_STAND_BY_ME.mid	Stand By Me	Ben E. King	Soul
BluesBrothers-EverybodyNeedsSomebody.mid	Everybody Needs Somebody	Blues Brothers	Soul
BOOKER_T___THE_MGs_TIME_IS_TIGHT.mid	Time is Right	Booker T and the MGs	Soul
can_t_turn_you_loose.mid	Can't Turn You Lose	Otis Redding	Soul
CHAIN_GANG.mid	Chain Gang	Sam Cooke	Soul
dock_of_the_bay_2.mid	Dock of the Bay	Otis Redding	Soul
gonions.mid	Green Onions	Booker T and the MGs	Soul
HOLD_ON_I_M_COMING.mid	Hold on I'm Coming	Sam and Dave	Soul
I_NEVER_LOVED_A_MAN__THE_WAY_I_LOVE_YOU.mid	I Never Loved a Man the Way I Love You	Aretha Franklin	Soul
my_girl.mid	My Girl	Otis Redding	Soul
respect.mid	Respect	Aretha Franklin	Soul
SOULFINGER.mid	Soul Finger	Jnr Walker and the All Stars	Soul
supremes_stop_in_the_name_of_love.mid	Stop in the Name of Love	Diana Ross and the Supremes	Soul
takriver.mid	Take me to the River	Al Green	Soul
THE_BLUES_BROTHERS_FLIP_FLOP_BLUES.mid	Filp Flop Blues	Blues Brothers	Soul
THE_BLUES_BROTHERS_SHAKE_A_TAILFEATHER_BABY.mid	Shake a Tailfeather Baby	Blues Brothers	Soul
THE_COMMITMENTS_MIDNIGHT_HOUR.mid	Midnight Hour	The Commitments	Soul
THE_COMMITMENTS_TRY_A_LITTLE_TENDERNESS.mid	Try a Little Tenderness	The Commitments	Soul
THE_STAPLE_SINGERS_RESPECT_YOURSELF.mid	Respect Yourself	Staple Singers	Soul
these_arms_of_mine.mid	These Arms of Mine	Otis Redding	Soul
think.mid	Think	Aretha Franklin	Soul
WILSON_PICKET_MEDLEY.mid	Medley	Wilson Picket	Soul
A_Cold_Day_In_Hell.mid	A Cold Day in Hell	Gary Moore	Soul Blues
AlbertCollins_AGoodFoolIsHardToFind.mid	A Good Fool is Hard to Find	Albert Collins	Soul Blues
At_Last.mid	At Last	Etta James	Soul Blues
b00160.mid	Let the Good Times Roll	B B King	Soul Blues
barneys.mid	Barney's Blues	Anonymous	Soul Blues
BobbyBlueBland_ATouchOfBlues.mid	A Touch of Blues	Bobby Blue Bland	Soul Blues
doc-whos_been_talkin.mid	Who's Been Talkin'	Howlin' Wolf	Soul Blues
FreddieKing-HelpMeThroughTheDay.mid	Help Me Through the Day	Freddie King	Soul Blues
FreddieKing-SanHoZaySenSaSun.mid	San Ho Zay and Sen Sa Sun	Freddie King	Soul Blues
GaryMoore-StillGotTheBlues.mid	Still Got the Blues	Gary Moore	Soul Blues
Get_Off_My_Back.mid	Get Off my Back	BB King	Soul Blues
gtrblues.mid	Guitar Blues	Anonymous	Soul Blues
GuitarJazzBlues59.mid	Guitar Jazz Blues	Anonymous	Soul Blues
helpme.mid	Help Me	Sonny Boy Williamson	Soul Blues
How_Blue_Can_You_Get.mid	How Blue can you Get	BB King	Soul Blues
JACKIE_WILSON_BABY_WORKOUT.mid	Baby Workout	Jackie Wilson	Soul Blues
JimmieCox-NobodyKnowsWhenYouAreDownAndOut.mid	Nobody Knows you when You're Down and Out	Jimmie Cox	Soul Blues
Midnight_Train.mid	Midnight Train	Buddy Guy	Soul Blues
momagot.mid	Moma's Got the Blues	Anonymous	Soul Blues
RockMeBaby.mid	Rock Me Baby	BB King	Soul Blues
SonnyBWilliamsonII-UnSeenEye.mid	Unseen Eye	Sonny Boy Williamson	Soul Blues
Sweet_16.mid	Sweet 16	BB King	Soul Blues
TBoneWalker-CallItStormyMonday.mid	Call it Stormy Monday	TBone Walker	Soul Blues
THE_BLUES_BROTHERS_MINNIE_THE_MOOCHER.mid	Minnie the Moocher	Blues Brothers	Soul Blues
The_Thrill_Is_Gone.mid	The Thrill is Gone	BB King	Soul Blues
AFoggyD.mid	A Foggy Day	Anonymous	Swing
around1.mid	Don't Get Around Much Anymore	Duke Ellington	Swing
Atrain.mid	Take the A Train	Duke Ellington	Swing
Basiervg.mid	Basie, Straight Ahead	Anonymous	Swing
Bye_ByeG.mid	Bye Bye Blackbird	Anonymous	Swing
Corner_pocket.mid	Corner Pocket	Count Basie	Swing
CottonG.mid	Conttontail	Duke Ellington	Swing
dontmean.mid	It Don't Mean a Thing	Duke Ellington	Swing
fever.mid	Fever	Anonymous	Swing
FreckleFace.mid	Freckle Face	Count Basie	Swing
gottatry.mid	Ya Gotta Try	Count Basie	Swing
grooving_hard.mid	Grooving Hard	Buddy Rich	Swing
Had2bu.mid	It Had to be You	Anonymous	Swing
hayBurner.mid	Have You Heard	Count Basie	Swing
NeverG.mid	Ill Never Say Never Again	Fletcher Henderson	Swing
NothinG.mid	Do Nothing 'Till You Hear From Me	Duke Ellington	Swing
Perdido.mid	Perdido	Duke Ellington	Swing
perfect.mid	Nobody's Perfect	Count Basie	Swing
SingSing.mid	Sing Sing Sing	Benny Goodman	Swing
Skylark.mid	Skylark	Anonymous	Swing
sophist.mid	Sophisticated Lady	Duke Ellington	Swing
ST_LOUIS.mid	St. Louis Blues	Glenn Miller	Swing
Takerv3g.mid	I'll Take Romance	Anonymous	Swing
timeaftertime.mid	Time After Time	Anonymous	Swing
world.mid	I've Got the World on a String	Anonymous	Swing
ab-astor_tango.mid	Tango A	Anonymous	Tango
ab-cumparsita_tango.mid	La Cumparsita B	Anonymous	Tango
astor_tango.mid	Astor Tango	Anonymous	Tango
Astor-tango.mid	Tango B	Astor Piatzola	Tango
cumparsita_tango.mid	Cumparsita Tango	Anonymous	Tango
dedi.mid	Dedicado a Te	Anonymous	Tango
lapin.mid	Lapin	Anonymous	Tango
madunn.mid	Madunn	Anonymous	Tango
ombra.mid	Tango Ombra	Anonymous	Tango
por_una.mid	Por Una Cabez	Anonymous	Tango
romino.mid	Tango Romino	Anonymous	Tango
tango_alaluzde.mid	A la luz del candil	Anonymous	Tango
tango_alousie.mid	Alousie	Anonymous	Tango
tango_boedo.mid	Boedo	Anonymous	Tango
tango_celos.mid	Celos	Anonymous	Tango
tango_chique.mid	Chique	Anonymous	Tango
tango_cumparsa.mid	La Cumparsita A	Anonymous	Tango
tango_elchoclo.mid	El Choco	Anonymous	Tango
tango_lapunial.mid	La pualada	Anonymous	Tango
tango_marplata.mid	Mar del Plata	Anonymous	Tango
tango_tangoarg.mid	Tango Arentino	Anonymous	Tango
tango_t-uno.mid	Tango Uno	Anonymous	Tango
tangoaa1.mid	Tango C	Anonymous	Tango
TangoArg.mid	Tango Argentino	Anonymous	Tango
tangoen_wb.mid	Tango en Skai	Roland Dyens	Tango
ACKER-GS.mid	Acker	Anonymous	Techno
around_the_world.mid	Around the World	Daft Punk	Techno
control.mid	Take Control	DJ Bobo	Techno
d-100purelove.mid	100 Pure Love	Anonymous	Techno
d-123trainwithme.mid	123 Train With Me	Anonymous	Techno
DANCE.mid	Dance	Anonymous	Techno
d-anotherday.mid	Another Day	Anonymous	Techno
d-anothernight.mid	Another Night	Anonymous	Techno
d-anything.mid	Anything	Anonymous	Techno
d-automaticlover.mid	Automatic Lover	Anonymous	Techno
d-badboy.mid	Bad Boy	Anonymous	Techno
d-beautifullife.mid	Beautiful Life	Anonymous	Techno
d-becauseimlovingyou.mid	Becaue I'm Loving You	Anonymous	Techno
d-bemylover.mid	Be My Lover	Anonymous	Techno
d-callme.mid	Call Me	Anonymous	Techno
d-celebratethelove.mid	Celebrate the Love	Anonymous	Techno
d-children.mid	Children	Anonymous	Techno
d-closetoyou.mid	Close to You	Anonymous	Techno
d-cometakemyhand.mid	Come Take my Hand	Anonymous	Techno
d-dancingwithanangel.mid	Dancing With An Angel	Anonymous	Techno
dream.mid	Never Ending Dream	Xperience	Techno
roses_are_red.mid	Roses Are Red	Aqua	Techno
runaway.mid	Run Away	Real McCoy	Techno
TECHNO.mid	Techno	Anonymous	Techno
whatlove.mid	What is Love	Haddaway	Techno
Act_Naturally.mid	Act Naturally	Buck Owens 	Traditional Country
Back_In_The_Saddle_Again.mid	Back in the Saddle Again	Gene Autry	Traditional Country
Crazy_Arms.mid	Crazy Arms	Patsy Cline	Traditional Country
Crazy.mid	Crazy	Patsy Cline	Traditional Country
Cryin_Time.mid	Crying Time	Ray Charles	Traditional Country
Four_In_The_Morning.mid	Four in the Morning	Faron Young	Traditional Country
Hey_Good_Lookin.mid	Hey Good Lookin	Hank Williams	Traditional Country
I_Fall_To_Pieces.mid	I Fall to Pieces	Patsy Cline	Traditional Country
Im_Movin_On.mid	Im Monving On	Hank Snow	Traditional Country
Jackson.mid	Jackson	Johnny Cash	Traditional Country
Okie_From_Muskogee.mid	Okie From Muskogee	Merle Haggard	Traditional Country
San_Antonio_Rose.mid	San Antonio Rose	Bob Willis and His Texas Playboys	Traditional Country
Shes_Got_You.mid	Shes Got You	Patsy Cline	Traditional Country
Sioux_City_Sue.mid	Sioux City Sue	Gene Autry	Traditional Country
Six_Days_On_The_Road.mid	Six Days on the Road	Dave Dudley	Traditional Country
Stand_By_Your_Man.mid	Stand By Your Man	Tammy Wynette	Traditional Country
Take_This_Job_And_Shove_It.mid	Take This Job and Shove It	Johnny Paycheck	Traditional Country
Tennessee_Waltz.mid	Tennesse Waltz	Roy Acuf	Traditional Country
Together_Again.mid	Together Again	Buck Owens	Traditional Country
Walkin_After_Midnight.mid	Walkin After Midnight	Patsy Cline	Traditional Country
Walkin_The_Floor_Over_You.mid	Walkin the Foloor Over You	Ernest Tubb	Traditional Country
Wasted_Days_n_Wasted_Nights.mid	Wasted Days and Wasted Nights	Freddy Fender	Traditional Country
Wild_Side_Of_Life.mid	Wild Side of Life	Hank Thompson	Traditional Country
You_Aint_Woman_Enough.mid	You Aint Woman Enough	Loretta Lynn 	Traditional Country
Your_Cheatin_Heart.mid	Your Cheatin Heart	Hank Williams	Traditional Country
